#########
# .     #
# $ $.  #
#   @   #
#########
